@@@@@@@@@@@@@@@@@@@@@@@@@@@@@@@@@@@@@@@@@@@@@@@@@@@@@@@@@@@@@@@@@@@@@@@%%%#**+++++*#%%%%###**+=--------=+#@@%@@@@@@@@@@@@@@@@@@@@@@@@@@@@@@@@@@@@@@@@@@@@@@@@@@@@@@@@@@@@@@@@@@@@@@@@@@@@@@@@@@@@@@@@@@@@@@@@@@@@@@@@@@@@@@@@@@@@@@@@@@@@@@@@@@@@@@@@@@@@@
@@@@@@@@@@@@@@@@@@@@@@@@@@@@@@@@@@@@@@@@@@@@@@@@@@@@@@@@@*%@@@*#%+@+:      :-+===+=                      =+#@@@@@@@@@@@@@@@@@@@@@@@@@@@@@@@@@@@@@@@@@@@@@@@@@@@@@@@@@@@@@@@@@@@@@@@@@@@@@@@@@@@@@@@@@@@@@@@@@@@@@@@@@@@@@@@@@@@@@@@@@@@@@@@@@@@@@@@@@@@@@@
@@@@@@@@@@@@@@@@@@@@@@@@@@@@@@@@@@@@@@@@@@@@@@@%%#*-··+*++@@@+++=+=--==*%%@@@@@#**+-                    ·@@@@@@@@@@@@@@@@@@@@@@@@@@@@@@@@@@@@@@@@@@@@@@@@@@@@@@@@@@@*++==-   ··::=%@@@@@@@@@@@@@@@@@@@@@@@@@@@@@@@@@@@@@@@@@@@@@@@@@@@@@@@@@@@@@@@@@@@@@@@
@@@@@@@@@@@@@@@@@@@@@@@@%@@@@@@@@@@@@@@@@@@%=--   ·-=+:#@@+::=+=-:::···:=*@@@@@@@@@%                   *@@@@@@@@@@@@@@@@@@@@@@@@@@@@@@@@@@@@@@@@@@@@@@@@@@%:-#+#+-:                 ··::-:··-+%@*##*===++*#%%%@@@@@@@@@@@@@@@@@@@@@@@@@@@@@@@@@@@@@@@@@@@@
@@@@@@@@@@@@@@@@%#+=:     ··::-=+*#+++=-:-=+*#+  ::·-::#*+=   %%: =**=     +@@@@@@@+              :-+*%@@@@@@@@@@@@@@@@@@@@@#+-:·    :=+*%@@@@%@@@%%@#===+*-· --·                                                -====+*=:-=+*#%@@@@@@@@@@@@@@@@@@@@@@@@@@
@@@@@@@@@@@@#*+=                              ····   ··       --=#@@%+=  ·: -%@@@@@        ·:-=*%@@@#*%%##@@@@@@@@@@@@@@@@@+     ··     ·---+*·:-              -·                                                                 ·:==+*@@@@@@@@@@@@@@@@@@
@@@@@@@@@%#+-·                                           :=*#++#@@#*#-  ::%@@@@@@@@     ·*@@@@@@@@@@@#==+#@@@@@@@@@@@@@#++·   ·=+-       ::·                                                                                       :*%%#@@@@@@@@@@@@@@@@@@
@@@@@@@+      ::··--:·                               -+%@@@@@@@%·   :%@@#@@@@@@@@@@*-:-#@@@@@@@@@@@@@@@@@@@@@@@@@@@@@@:       *@*·:::·                                                                                  +%*+# ·::--%@@@@@@@@@@@@@@@@@@@@@@
@@@@@@@%=·:-+%@@@@@@@@@                             :@@@@@@@@@%      -:  %@@@@@@@@@@@@@@@@@@@@@@@@@@@@@@@@@@@@%==@@@@@%==++  ·#@@%+                                                                             -@@@@@%%@@@@: :*@@@@@@@@@@@@@@@@@@@@@@@@@@
@%###**#%@@@@@@@@@@@@@@:                              ·=+#@@%*:          =%@@@@@@@@@@@@@@@@@@@@@@@@@@@@@@@@@%*=  *@@@@@@- =-=#%@+                                                                               #@@@@@@@@@@@+·   *@@@@@@@@@@@@@@@@@@@@@@@@
@@@@@@@@@@@@@@@@@@@@@@@@                                 :@=               %@@@@@@@@@@@@@@@@@@@@@@@@@@@@@@@: :%+  :#@#-:·                                                                                        · ·=@@@@@@@@@#- =@@@@@@@@@@@@@@@@@@@@@@@@
@@@@@@@@@@@@@@@@@@@@@@@+                                         ·:-===+=::%@@@@@@@@@@@@@@@@@@@@@@@@@@@@@@@@@@%*+==-·                                                                                                ·#@@@@@@@@@@@@@@@@@@@@@@@@@@@@@@@@@@@
@@@@@@@@@@@@@@@@@@@@@@@%                                        ·  #@@@%==::@@@@@@@@@@@@@@@@@@@@@@@@@@@@@@@@@@%=·                                                                                                     :@@@@@@@@@@@@@@@@@@@@@@@@@@@@@@@@@@@
@@@@@@@@@@@@@@@@@@@@@@*                                        ·:  +**@@@@@@@@@@@@@@@@@@@@@@@@@@@@@@@@@@@@@@@@@@%          -:          ·*%=:##·     ·*%*:                                                             =@@@@@@@@@@@@@@@@@@@@@@@@@@@@@@@@@@@
@@@@@@@@@@@@@@@@@@@@%·                                       -@@@@@@@@@@@@@@@@@@@@@@@@@@@@@@@@@@@@@@@@@@@@@··:::·   =#*%@%- =+=:      ·%@@%#%@@%+    +@%+                                                          -++@@@@@@@@@@@@@@@@@@@@@@@@@@@@@@@@@@@@
@@@@@@@@@@@@@@@@@@@@·                                    :*%@@@@@@@@@@@@@@@@@@@@@@@@@@@@@@@@@@@@@@@@@@@@@@#       *@@@@@@@@@#·=%+  :+=         ·       #@%:                                                 -*·-: :@@@@@@@@@@@@@@@@@@@@@@@@@@@@@@@@@@@@@@@
@@@@@@@@@@@@@@@@@@@@·                                  :%@@@@@@@@@@@@@@@@@@@@@@@@@@@@@@@@@@@@@@@@@@@@@@@@@#:·  ·-%@@@%%##%@%++@@@%::%@=                +%@*                                                 -*+*@+··+@@@@@@@@@@@@@@@@@@@@@@@@@@@@@@@@@@@@@
@@@@@@@@@@@@@@@@@@@@-                                ·=%@@@@@@@@@@@@@@@@@@@@@@@@@@@@@@@@@@@@@@@@@@@@@@@@@@@@*·++=:        @@@@@@@@@@@@@@%@%#@+                                                                -@@@@·:%@@@@@@@@@@@@@@@@@@@@@@@@@@@@@@@@@@@@
@@@@@@@@@@@@@@@@@@@@@#                            ·+%@@@@@@@@@@@@@@@@@@@@@@@@@@@@@@@@@@@@@@@@@@@@@@@@@@@@@=·              :=+@@@@+=+*%@@@@@@#                                                                   *@@@@@@@@@@@@@@@@@@@@@@@@@@@@@@@@@@@@@@@@@
@@@@@@@@@@@@@@@@@@@@@@:*+              :-:-+++-: =@@@@@@@@@@@@@@@@@@@@@@@@@@@@@@@@@@@@@@@@@@@@@@@@@@@@@@@=                    ·:-                      ·=·                                                       #@@@@@@@@@@@@@@@@@@@@@@@@@@@@@@@@@@@@@@@@
@@@@@@@@@@@@@@@@@@@@@@*·%+          =#@@@@@@@@@% +@@@@@@@@@@@@@@@@@@@@@@@@@@@@@@@@@@@@@@@@@@@@@@@@@@@@%-                                    :+          +@*-::-                                                  %@@@@@@@@@@@@@@@@@@@@@@@@@@@@@@@@@@@@@@@@
@@@@@@@@@@@@@@@@@@@@@@@%:@+        ·@@@@@@@@@@@@#%@@@@@@@@@@@@@@@@@@@@@@@@@@@@@@@@@@@@@@@@@@@@@@@@@@@+                                       +@:         ·=@#--%#**+++=                                         *%*@@@@@@@@@@@@@@@@@@@@@@@@@@@@@@@@@@@@@@@
@@@@@@@@@@@@@@@@@@@@@@@@%%@%:      #@@@@@@@@@###*+*%@@@@@@@@@@@@@@@@@@@@@@@@@@@@@@@@@@@@@@@@@@@@@@@@-                                         =@=               :%@@@@@@*                ·:                 ·-+%@#+@@@@@@@@@@@@@@@@@@@@@@@@@@@@@@@@@@@@@@@
@@@@@@@@@@@@@@@@@@@@@@@@@@@@+      -@@@@+ =@@@@@@@--*@#**%@@@@@@@@@@@@@@@@@@@@@@@@@@@@@@@@@@@@@@@@@@                                           =@+              +@@@@@@@@@%%          -%@@@#:          *@*=@@@@@@@@@@@@@@@@@@@@@@@@@@@@@@@@@@@@@@@@@@@@@@@
@@@@@@@@@@@@@@@@@@@@@@@@@@@@@@#=:    ·   :@@@@@@@@@@@%**#%@@@@@@@@@@@@@@@@@@@@@@@@@@@@@@@@@@@@@@@@@@:                                           :@#·        ·-*@@@@@@@@@@@@@+       =%@@@@@@@- ·       -#@@@@@@@@@# %@@@@@@@@@@@@@@@@@@@@@@@@@@@@@@@@@@@@@
@@@@@@@@@@@@@@@@@@@@@@@@@@@@@@@@@@%%@*:   ··:#@@@@@@@@@@@@@@@@@@@@@@@@@@@@@@@@@@@@@@@@@@@@@@@@@@@@@+                                             ·#*     :=%@@@@@@@@@@@@@@@@@-    =@@@@@@@@@@@%@+        -@@@@@@@@+ #@@@@@@@@@@@@@@@@@@@@@@@@@@@@@@@@@@@@@
@@@@@@@@@@@@@@@@@@@@@@@@@@@@@@@@@@@@@@@@%*·  @@@@@@@@@#@@@@@@@@@@@@@@@@@@@@@@@@@@@@@@@@@@@@@@@@@@@@#                                               :++#%@@%@@@@@@@@@@@@@@@@@@@:   =@@@@@@@@@@@@@@::=:     *@@@@@@@@*#=+%@@@@@@@@@@@@@@@@@@@@@@@@@@@@@@@@@@
@@@@@@@@@@@@@@@@@@@@@@@@@@@@@@@@@@@@@@@@@@@- *@%%@@=· :  ·:---+@@@@@@@@@@@@@@@@@@@@@@@@@@@@@@@@@@@@@@*·                                              -:·  :@@@@@@@@@@@@@@@@@@@@:  +%@@@@@@@@@@@@@=*@@%= =#@@@@@@@@@@%-+-%@@@@@@@@@@@@@@@@@@@@@@@@@@@@@@@@@
@@@@@@@@@@@@@@@@@@@@@@@@@@@@@@@@@@@@@@@@@@@@@#+*@:·             -#@@@@@@@@@@@@@@@@@@@@@@@@@@@@@@@@@@@@%-                                                 :@@@@@@@@@@@@@@@@@@@@@@#@+ @@@@@@@@@@@@@#-=%@@@@@@@@@@@%%@@@#= +@@@@@@@@@@@@@@@@@@@@@@@@@@@@@@@@@
@@@@@@@@@@@@@@@@@@@@@@@@@@@@@@@@@@@@@@@@@@@@@@@@@+                 ·:-#@@@@@@@@@@@@@@@@@@@@@@@@@@@@@@@@@@+::===-+#@@@*                                  +@@@@@@@@@@@@@@@@@@@@@@@@@@@@@@@@@@@@@@**@@= =@@@@@@@@@*· *@@@@#@@@@@@@@@@@@@@@@@@@@@@@@@@@@@@@@@@
@@@@@@@@@@@@@@@@@@@@@@@@@@@@@@@@@@@@@@@@@@@@@@@@#·                     =@@@@@@@@@@@@@@@@@@@@@@@@@@@@@@@@@@@@@@@@@@@@@@@@@:                            -%@@@@@@@@@@@@@@@@@@@@@@@@@@@@@@@@@@@@@@@@#-:+-·+@@@@@#-   :@@@@@@@@@@@@@@@@@@@@@@@@@@@@@@@@@@@@@@@@
@@@@@@@@@@@@@@@@@@@@@@@@@@@@@@@@@@@@@@@@@@@@@@@-                        -%%@@@@@@@@@@@@@@@@@@@@@@@@@@@@@@@@@@@@@@@@@@@@@%                          ·+@@@@@@@@@@@@@@@@@@@@@@@@@@@@@@@@@@@@@@@@@@@@@#  :*@@@%      =@=*+*#@@@@%##@@@@@@@@@@@@@@@@@@@@@@@@@@@
@@@@@@@@@@@@@@@@@@@@@@@@@@@@@@@@@@@@@@@@@@@@@@%                             :+++*%@@@@@@@@@@@@@@@@@@@@@@@@@@@@@@@@@@@@@@@+                        +@@@@@@@@@@@@@@@@@@@@@@@@@@@@@@@@@@@@@@@@@@@@@@@@%·  -%@@+·   -@* ·+@@@@@@@* -#-··-+%@@@@@@@@@@@@@@@@@@@
@@@@@@@@@@@@@@@@@@@@@@@@@@@@@@@@@@@@@@@@@@@@@@*                                   :*@@@@@@@@@@@@@@@@@@@@@@@@@@@@@@@@@@@@@@#                      +@@@@@@@@@@@@@@@@@@@@@@@@@@@@@@@@@@@@@@@@@@@@@@@@@@@=· @@@@@@@%@@%:%-@@@@@@@@@%*=·     *@@@@@@@@@@@@@@@@@
@@@@@@@@@@@@@@@@@@@@@@@@@@@@@@@@@@@@@@@@@@@@@@@*                                    #@@@@@@@@@@@@@@@@@@@@@@@@@@@@@@@@@@@@@@#                     *@@@@@@@@@@@@@@@@@@@@@@@@@@@@@@@@@@@@@@@@@@@@@@@@@@@@@@*=+=::+##%%@%%%%%@@@@@@@@@*    - :@@@@@@@@@@@@@@@@
@@@@@@@@@@@@@@@@@@@@@@@@@@@@@@@@@@@@@@@@@@@@@@@@@-                                 -@@@@@@@@@@@@@@@@@@@@@@@@@@@@@@@@@@@@@@@@·                    :@@@@@@@@@@@@@@@@@@@@@@@@@@@@@@@@@@@@@@@@@@@@@@@@@@@@@@@@@@@@@%@%%%%%*#@@@@@@@@@@@@@#@@@*=%@@@@@@@@@@@@@@
@@@@@@@@@@@@@@@@@@@@@@@@@@@@@@@@@@@@@@@@@@@@@@@@@@*                               +@@@@@@@@@@@@@@@@@@@@@@@@@@@@@@@@@@@@@@@@@·                     @@@@@@%+@@@@@@@@@@@@@@@@@@@@@@@@@@@@@@@@@@@@@@@@@@@@@@@@@@@@@@@@@@@@@@@@@*= :-+@@@@-@@@@@@@@@@@@@@@@@@@@
@@@@@@@@@@@@@@@@@@@@@@@@@@@@@@@@@@@@@@@@@@@@@@@@@@@#·                            ·@@@@@@@@@@@@@@@@@@@@@@@@@@@@@@@@@@@@@@@@@-                      @@@@%=  @@@@@@@@@@@@@@@@@@@@@@@@@@@@@@@@@@@@@@@@@@@@@@@@@@@@@@@@@@@@#- =-    ·%@@@= -@@@@@@@@@@@@@@@@@@@
@@@@@@@@@@@@@@@@@@@@@@@@@@@@@@@@@@@@@@@@@@@@@@@@@@@@@%+:                         =@@@@@@@@@@@@@@@@@@@@@@@@@@@@@@@@@@@@@@@@@·                   ·=%@@#·   #@@@@@@@@@@@@@@@@@@@@@@@@@@@@@@@@@@@@@@@@@@@@@@@@@@@@@@@@@@-·           -+=   *@@@@@@@@@@@@@@@@@@
@@@@@@@@@@@@@@@@@@@@@@@@@@@@@@@@@@@@@@@@@@@@@@@@@@@@@@@@*                        %@@@@@@@@@@@@@@@@@@@@@@@@@@@@@@@@@@@@@@@@@%                 :%@@@@@#   =@@@@@@@@@@@@@@@@@@@@@@@@@@@@@@@@@@@@@@@@@@@@@@@@@@@@@@%*+-                     =@@@@@@@@@@@@@@@@@
@@@@@@@@@@@@@@@@@@@@@@@@@@@@@@@@@@@@@@@@@@@@@@@@@@@@@@@@@                     :=%@@@@@@@@@@@@@@@@@@@@@@@@@@@@@@@@@@@@@@@@@@@*                ·@@@@@@·  ·@@@@@@@@@@@@@@@@@@@@@@@@@@@@@@@@@@@@@@@@@@@@@@@@@@@@%:                           :%@@@@@@@@@@@@@@@
@@@@@@@@@@@@@@@@@@@@@@@@@@@@@@@@@@@@@@@@@@@@@@@@@@@@@@@@@·                 +#@@@@@@@@@@@@@@@@@@@@@@@@@@@@@@@@@@@@@@@@@@@@@@@@               =%@@@@@@=:=@@@@@@@@@@@@@@@@@@@@@@@@@@@@@@@@@@@@@@@@@@@@@@@@@@@@@:                              %@@@@@@@@@@@@@@
@@@@@@@@@@@@@@@@@@@@@@@@@@@@@@@@@@@@@@@@@@@@@@@@@@@@@@@@@:                ·@@@@@@@@@@@@@@@@@@@@@@@@@@@@@@@@@@@@@@@@@@@@@@@@@@+             +@@@@@@@@@@@@@@@@@@@@@@@@@@@@@@@@@@@@@@@@@@@@@@@@@@@@@@@@@@@@@@@@                              ·@@@@@@@@@@@@@@@
@@@@@@@@@@@@@@@@@@@@@@@@@@@@@@@@@@@@@@@@@@@@@@@@@@@@@@@@@-               :#@@@@@@@@@@@@@@@@@@@@@@@@@@@@@@@@@@@@@@@@@@@@@@@@@@@*          :*@@@@@@@@@@@@@@@@@@@@@@@@@@@@@@@@@@@@@@@@@@@@@@@@@@@@@@@@@@@@@@@@@·                            ·%@@@@@@@@@@@@@@@
@@@@@@@@@@@@@@@@@@@@@@@@@@@@@@@@@@@@@@@@@@@@@@@@@@@@@@@@@#              =@@@@@@@@@@@@@@@@@@@@@@@@@@@@@@@@@@@@@@@@@@@@@@@@@@@@@@=       -#@@@@@@@@@@@@@@@@@@@@@@@@@@@@@@@@@@@@@@@@@@@@@@@@@@@@@@@@@@@@@@@@@@%      :=+*##*=·            ·+@@@@@@@@@@@@@@@@@
@@@@@@@@@@@@@@@@@@@@@@@@@@@@@@@@@@@@@@@@@@@@@@@@@@@@@@@@@*          ·=*#@@@@@@@@@@@@@@@@@@@@@@@@@@@@@@@@@@@@@@@@@@@@@@@@@@@@@@@@**#%%@@@@@@@@@@@@@@@@@@@@@@@@@@@@@@@@@@@@@@@@@@@@@@@@@@@@@@@@@@@@@@@@@@@@@@+=+#%@@@@@@@@@@%*+        ·#@@@@@@@@@@@@@@@@##@
@@@@@@@@@@@@@@@@@@@@@@@@@@@@@@@@@@@@@@@@@@@@@@@@@@@@@@@@@*           -@@@@@@@@@@@@@@@@@@@@@@@@@@@@@@@@@@@@@@@@@@@@@@@@@@@@@@@@@@@@@@@@@@@@@@@@@@@@@@@@@@@@@@@@@@@@@@@@@@@@@@@@@@@@@@@@@@@@@@@@@@@@@@@@@@@@@@@@@@@@@@@@@@@@@@@:     -=@@@@@@@@@@@@@@@@@@-:#
@@@@@@@@@@@@@@@@@@@@@@@@@@@@@@@@@@@@@@@@@@@@@@@@@@@@@@@@@@·       =%@@@@@@@@@@@@@@@@@@@@@@@@@@@@@@@@@@@@@@@@@@@@@@@@@@@@@@@@@@@@@@@@@@@@@@@@@@@@@@@@@@@@@@@@@@@@@@@@@@@@@@@@@@@@@@@@@@@@@@@@@@@@@@@@@@@@@@@@@@@@@@@@@@@@@@@@@@@#%#@@@@@@@@@@@@@@@@@@%@::*@
@@@@@@@@@@@@@@@@@@@@@@@@@@@@@@@@@@@@@@@@@@@@@@@@@@@@@@@@@@#-     +@@@@@@@@@@@@@@@@@@@@@@@@@@@@@@@@@@@@@@@@@@@@@@@@@@@@@@@@@@@@@@@@@@@@@@@@@@@@@@@@@@@@@@@@@@@@@@@@@@@@@@@@@@@@@@@@@@@@@@@@@@@@@@@@@@@@@@@@@@@@@@@@@@@@@@@@@@@@+·=@@@@@@@@@@@@@@@#+=+#%@@@@
@@@@@@@@@@@@@@@@@@@@@@@@@@@@@@@@@@@@@@@@@@@@@@@@@@@@@@@@@@@-     #@@@@@@@@@@@@@@@@@@@@@@@@@@@@@@@@@@@@@@@@@@@@@@@@@@@@@@@@@@@@@@@@@@@@@@@@@@@@@@@@@@@@@@@@@@@@@@@@@@@@@@@@@@@@@@@@@@@@@@@@@@@@@@@@@@@@@@@@@@@@@@@@@@@@@@@@@@@@@@@@@@@@@@@@@@#=-=*%@@@@@@@@
@@@@@@@@@@@@@@@@@@@@@@@@@@@@@@@@@@@@@@@@@@@@@@@@@@@@@@@@@@@%     :@@@@@@@@@@@@@@@@@@@@@@@@@@@@@@@@@@@@@@@@@@@@@@@@@@@@@@@@@@@@@@@@@@@@@@@@@@@@@@@@@@@@@@@@@@@@@@@@@@@@@@@@@@@@@@@@@@@@@@@@@@@@@@@@@@@@@@@@@@@@@@@@@@@@@@@@@@@@@@@@@@@@@@@@@@@@@@@@@@@@@@@@
@@@@@@@@@@@@@@@@@@@@@@@@@@@@@@@@@@@@@@@@@@@@@@@@@@@@@@@@@@@@#·   =@@@@@@@@@@@@@@@@@@@@@@@@@@@@@@@@@@@@@@@@@@@@@@@@@@@@@@@@@@@@@@@@@@@@@@@@@@@@@@@@@@@@@@@@@@@@@@@@@@@@@@@@@@@@@@@@@@@@@@@@@@@@@@@@@@@@@@@@@@@@@@@@@@@@@@@@@@@@@@@@@@@@@@@@@@@@@@@@@@@@@@@@
@@@@@@@@@@@@@@@@@@@@@@@@@@@@@@@@@@@@@@@@@@@@@@@@@@@@@@@@@@@@@@#=--+*#@@@@@@@@@@@@@@@@@@@@@@@@@@@@@@@@@@@@@@@@@@@@@@@@@@@@@@@@@@@@@@@@@@@@@@@@@@@@@@@@@@@@@@@@@@@@@@@@@@@@@@@@@@@@@@@@@@@@@@@@@@@@@@@@@@@@@@@@@@@@@@@@@@@@@@@@@@@@@@@@@@@@@@@@@@@@@@@@@@@@@